string.h 라이브러리 함수

문자열 복사 함수
memcpy : 메모리의 특정한 블록을 복사한다.

memmove : 메모리의 특정한 블록을 이동시킨다.

strcpy : 문자열을 복사한다.

strncpy: 문자열에서 지정한 부분 만큼 복사한다.

문자열 합치는 함수
strcat : 두 개의 문자열을 합친다.

strncat : 두 개의 문자열을 지정한 부분 만큼 합친다.

문자열 비교 함수
memcmp : 메모리의 두 부분을 비교한다. 

strcmp : 두 개의 문자열을 비교한다.

strcoll : locale 을 이용하여 두 개의 문자열을 비교한다.

strncmp : 두 개의 문자열의 일부분을 비교한다.

strxfrm: locale 을 이용하여 문자열을 변환한다.

문자열 검색함수
memchr: 메모리 블록에서 특정한 문자를 찾는다.

strchr : 문자열에서 특정한 문자를 찾아 그 위치를 구한다.

strcspn : 특정한 문자열에 포함된 문자들을 다른 문자열에서 찾아 가장 먼저 나오는 것을 구한다.

strpbrk: 특정한 문자열에 포함된 문자들을 다른 문자열에서 찾아 일치되는 것을 가리킨다.

strrchr : 문자열에서 특정한 문자를 찾되, 뒤에서 부터 찾는다.

strspn : 특정한 문자열에서 다른 문자열에 포함되어 있는 부분을 찾되, 처음 부터 연속된 부분으로 구한다.

strstr : 특정한 문자열을 다른 문자열에서 검색한다.

strtok : 문자열을 토큰으로 분리한다.

다른 잡다한 함수들
memset : 메모리 블록을 채운다.

strerror : 오류 메세지 문자열을 가리키는 포인터를 구한다.

strlen : 문자열의 길이를 잰다.

매크로
NULL : 널 포인터

타입
size_t : 부호없는 정수

